2
2
2 1
8 8
- - 0 2 1 0 - -
- 0 0 1 2 0 0 -
i 0 0 0 0 0 0 0
0 0 0 - - 0 0 b
0 0 0 - - 0 0 0
0 0 b 0 0 x x 0
- 0 0 0 x 0 0 -
- - 0 0 0 0 - -
0 2 0 <-> 7 5 4
