3
4
2 2
10 15
0 x 0 - - - 0 0 0 - - - 0 x 0
0 0 0 - - - 0 i 0 - - - 0 0 0
0 0 0 - - - 0 0 0 - - - 0 0 0
0 0 b - - - 0 0 0 - - - b 0 0
0 0 0 0 0 0 0 0 0 0 0 0 0 0 0
0 0 0 c 0 0 1 3 2 0 0 c 0 0 0
0 0 0 0 0 0 3 2 1 0 0 0 0 0 0
- - - - 0 0 2 1 3 0 0 - - - -
- - - - 0 0 0 0 0 0 0 - - - -
- - - - 0 0 0 c 0 0 0 - - - -
2 0 0 <-> 13 0 0
