5
3
4 1
25 25
- - - - - 0 0 0 0 0 0 0 b 0 0 0 0 0 0 0 - - - - -
- - - - 0 0 0 0 0 0 0 0 0 0 0 0 0 0 0 0 0 - - - -
- - - 0 0 0 0 0 0 0 0 0 0 0 0 0 0 0 0 0 0 0 - - -
- - 0 0 0 x 0 0 0 0 0 0 0 0 0 0 0 0 0 x 0 0 0 - -
- 0 0 0 0 0 0 0 0 0 0 0 0 0 0 0 0 0 0 0 0 0 0 0 -
0 0 0 0 0 0 0 0 0 0 0 0 0 0 0 0 0 0 0 0 0 0 0 0 0
0 0 0 0 c 0 0 0 0 0 0 0 0 0 0 0 0 0 0 0 0 0 0 0 0
0 0 0 0 0 0 0 0 0 0 0 0 - 0 0 0 0 0 0 0 0 0 i 0 0
0 0 0 0 0 0 0 0 0 0 0 - - - 0 0 0 0 0 0 0 0 0 0 0
0 0 0 0 0 0 0 0 0 0 - - - - - 0 0 0 0 0 0 0 0 0 0
- 0 0 0 0 0 0 0 0 0 1 2 3 4 5 0 0 0 0 0 0 0 0 0 -
- - 0 0 0 0 0 0 0 0 2 3 4 5 1 0 0 0 0 0 0 0 0 - -
- - - 0 0 0 b 0 0 0 3 4 5 1 2 0 0 0 0 c 0 0 - - -
- - 0 0 0 0 0 0 0 0 4 5 1 2 3 0 0 0 0 0 0 0 0 - -
- 0 0 0 0 0 0 0 0 0 5 1 2 3 4 0 0 0 0 0 0 0 0 0 -
0 0 0 0 0 0 0 0 0 0 - - - - - 0 0 0 0 0 0 0 0 0 0
0 0 0 0 0 0 0 0 0 0 0 - - - 0 0 0 0 b 0 0 0 0 0 0
0 i 0 0 0 0 0 0 0 0 0 0 - 0 0 0 0 0 0 0 0 0 0 0 0
0 0 0 0 0 0 0 0 0 0 0 0 0 0 0 0 0 0 0 0 0 0 0 0 0
0 0 0 0 0 0 0 0 0 0 0 0 0 0 0 0 0 0 0 0 0 0 0 0 0
- 0 0 0 0 0 0 0 0 0 0 0 0 0 0 0 0 0 0 0 0 0 0 0 -
- - 0 0 0 x 0 0 0 0 0 0 0 0 0 0 0 0 0 x 0 0 0 - -
- - - 0 0 0 0 0 0 0 0 0 0 0 0 0 0 0 0 0 0 0 - - -
- - - - 0 0 0 0 0 0 0 0 c 0 0 0 0 0 0 0 0 - - - -
- - - - - 0 0 0 0 0 0 0 0 0 0 0 0 0 0 0 - - - - - 
6 0 0 <-> 10 24 4
